wwwwwwwwwwwwwwwwwwww
w..................w
w...a..............w
w..................w
w..............b...w
w.......w..........w
w...........c.....pp
wwwwwwwwwwwwwwww.p.w
w...............p..w
w..ppppppppppppp...w
w..pwwwwwwwwwwwwwwww
w..p........f......w
w...pp.............w
wwwwwp......h......w
w....p.............w
ppppp...i..........w
w.......w..........w
w.......w....j.....w
w.......w..........w
wwwwwwwwwwwwwwwwwwww
