wwwwwwwwpwwwwwwwwwww
w.......pa.........w
w.....b.pw..cw.....w
w.......p....w.....w
w.d......p...w.....w
w.........p..w.....w
w.....ww.e.p.w.....w
w.....w.....p......w
w.....w......p.....w
wwwwwwwwwwg..p.....w
w............p.....w
w............p.....w
w............p.....w
wwwwwwww.....p.....w
w............p.....w
w....i.......pwwwwww
w............ppppppp
w............j.....w
w..................w
wwwwwwwwwwwwwwwwwwww
